,学号,姓名,语文,数学,英语,美术,体育,总分,均分
0,1,郭靖,85,80,71,75,95,406,81.2
1,2,黄蓉,90,95,80,85,90,440,88.0
2,3,杨过,88,87,75,90,93,433,86.6
3,4,小龙女,92,83,70,88,91,424,84.8
4,5,乔峰,86,80,78,80,92,416,83.2
5,6,张无忌,91,92,78,89,90,440,88.0
6,7,韦小宝,98,95,70,70,85,418,83.6
7,8,洪七公,83,85,78,81,96,423,84.6
8,9,黄药师,94,95,80,96,98,463,92.6
9,10,周伯通,80,81,70,75,94,400,80.0
